1111111111111111
100E00000C000011
1001000011110001
1100000010000001
11100C000000P001
1111111111111111