111111111111111
100000000000001
100010001110001
1P0110010001C01
101010010001001
110010001111001
100010C00001001
1000100100E1001
100010001110001
111111111111111