1111111111111111
1C0E00000C000011
1001000011110001
1100000010000001
11110C0000000111
1110000000000001
1C00000000000P01
1111111111111111