1111111111111111
1C0E0M000C000011
1001000011110001
110M000010000001
11110C0000000111
1110000000000001
1C000M0000M00P01
1111111111111111