111111111
1000M0001
100MPM001
1E00M00C1
111111111